####################!!!!!!!!######
#                                #
#                                !
#                                !
#            ######              !
#            ######              #   
#            ######              #   
#            ###!!#              #
#                                #
#                           %%%%%#
#                           %    #
#        @@      $$         %    #
#        @@      $$         %    #
#        @@      $$         %    #
#        @       $$              #
#                       &&&&&&&&&#
#                                #
#                                #
##!!!!!!!!!!######################